Erdnuss	die
Erkenntnis	die
Erlaubnis	die
Fackel	die
Flut	die
Folter	die
Geisel	die
Ranch	die
Schulter	die
Stirn	die
Trauer	die
Couch	die
Jeans	die
Rückkehr	die
Schnur	die
Socke	die

Abenteuer	das
Abteil	das
Album	das
Alter	das
Aluminium	das
Angebot	das
Anwesen	das
Argument	das
Aroma	das
Artefakt	das
Ass	das
Auditorium	das
Auge	das
Augenlid	das
Auto	das
Baby	das
Backup	das
Bad	das
Becken	das
Bedürfnis	das
Bein	das
Bett	das
Bier	das
Bild	das
Blatt	das
Blei	das
Blut	das
Boot	das
Böse	das
Brett	das
Brot	das
Bündel	das
Café	das
Chaos	das
Cockpit	das
College	das
Dach	das
Datum	das
Deck	das
Denkmal	das
Design	das
Dessert	das
Detail	das
Diagramm	das
Dokument	das
Dorf	das
Drama	das
Dreieck	das
Echo	das
Ego	das
Ei	das
Eigentum	das
Eis	das
Eisen	das
Element	das
Elend	das
Ende	das
Engagement	das
Englisch	das
Entsetzen	das
Erdbeben	das
Ereignis	das
Ergebnis	das
Etikett	das
Exemplar	das
Fach	das
Fahrrad	das
Fahrzeug	das
Fass	das
Feld	das
Fernglas	das
Festival	das
Fett	das
Feuer	das
Fieber	das
Fleisch	das
Flugzeug	das
Foto	das
Foyer	das
Fragment	das
Frühstück	das
Fundament	das
Futter	das
Gas	das
Gebäude	das
Gebet	das
Gebiet	das
Gedicht	das
Gefängnis	das
Gefäß	das
Gefühl	das
Gehalt	das
Geheimnis	das
Gehirn	das
Gelände	das
Geländer	das
Geld	das
Gelenk	das
Gemälde	das
Gemüse	das
Genie	das
Gepäck	das
Gerät	das
Geräusch	das
Gericht	das
Gerücht	das
Geschäft	das
Geschenk	das
Geschirr	das
Gesetz	das
Gesicht	das
Gespräch	das
Getränk	das
Getreide	das
Getriebe	das
Gewebe	das
Gewehr	das
Gewicht	das
Gewissen	das
Gift	das
Glas	das
Glied	das
Glück	das
Gold	das
Grab	das
Gras	das
Grün	das
Grundstück	das
Haar	das
Handgelenk	das
Handwerk	das
	das
Heck	das
Hemd	das
Herz	das
Heu	das
Holz	das
Horn	das
Huhn	das
Imperium	das
Individuum	das
Ingenieurwesen	das
Innere	das
Insekt	das
Institut	das
Instrument	das
Interesse	das
Internet	das
Intervall	das
Interview	das
Jahr	das
Jahrhundert	das
Jahrzehnt	das
Journal	das
Jubiläum	das
Juwel	das
Kabel	das
Kalb	das
Kamel	das
Kapitel	das
Kasino	das
Kaugummi	das
Kinn	das
Kissen	das
Klavier	das
Kleid	das
Knie	das
Kompliment	das
Konto	das
Konzept	das
Konzert	das
Korn	das
Kostüm	das
Kreuz	das
Kupfer	das
Labor	das
Labyrinth	das
Lachen	das
Lager	das
Lamm	das
Land	das
Lebensmittel	das
Lebewesen	das
Leder	das
Licht	das
Lied	das
Lob	das
Loch	das
Magazin	das
Make-up	das
Management	das
Manuskript	das
Märchen	das
Maß	das
Material	das
Maximum	das
Medikament	das
Meer	das
Mehl	das
Menü	das
Merkmal	das
Messer	das
Messing	das
Metall	das
Mikrofon	das
Mitglied	das
Mitleid	das
Modell	das
Monster	das
Motel	das
Motiv	das
Muster	das
Nest	das
Netz	das
Netzwerk	das
Objekt	das
Ohr	das
Öl	das
Opfer	das
Organ	das
Ostern	das
Outfit	das
Paar	das
Paket	das
Panel	das
Papier	das
Paradies	das
Parfüm	das
Personal	das
Pferd	das
Phänomen	das
Picknick	das
Plastik	das
Podium	das
Pony	das
Porträt	das
Porzellan	das
Poster	das
Prinzip	das
Privileg	das
Problem	das
Produkt	das
Profil	das
Programm	das
Projekt	das
Publikum	das
Pulver	das
Quadrat	das
Rad	das
Radio	das
Rätsel	das
Recht	das
Regal	das
Register	das
Reh	das
Reich	das
Rennen	das
Reservat	das
Resort	das
Restaurant	das
Rezept	das
Rindvieh	das
Risiko	das
Ritual	das
Rohr	das
Salz	das
Sandwich	das
Schach	das
Schaf	das
Schema	das
Schicksal	das
Schiff	das
Schild	das
Schließfach	das
Schloss	das
Schwein	das
Schwert	das
Seil	das
Semester	das
Seminar	das
Signal	das
Silber	das
Skelett	das
Skript	das
Sofa	das
Spektakel	das
Spiel	das
Spray	das
Steak	das
Stück	das
Studio	das
Symbol	das
Symptom	das
System	das
Szenario	das
T-Shirt	das
Tablett	das
Tageslicht	das
Tal	das
Talent	das
Tattoo	das
Taxi	das
Team	das
Telefon	das
Teleskop	das
Tennis	das
Terminal	das
Theater	das
Thema	das
Tier	das
Tor	das
Training	das
Treffen	das
Trikot	das
Tuch	das
Unkraut	das
Unternehmen	das
Urteil	das
Vakuum	das
Verbrechen	das
Verfahren	das
Vergnügen	das
Versteck	das
Vertrauen	das
Video	das
Viertel	das
Virus	das
Volk	das
Volumen	das
Wachs	das
Wachstum	das
Wesen	das
Wetter	das
Wissen	das
Wort	das
Wrack	das
Wunder	das
Zeichen	das
Zelt	das
Ziel	das
Zimmer	das
Zuhause	das

Abend	der
Abfall	der
Abfluss	der
Absatz	der
Abschied	der
Abschluss	der
Abstieg	der
Adel	der
Affe	der
Akt	der
Akzent	der
Alarm	der
Albtraum	der
Alkohol	der
Altar	der
Anblick	der
Anfang	der
Angriff	der
Anker	der
Anruf	der
Ansatz	der
Anstieg	der
Anzug	der
Apfel	der
Appell	der
Appetit	der
Applaus	der
Ärger	der
Arm	der
Ärmel	der
Artikel	der
Aspekt	der
Asphalt	der
Ast	der
Asteroid	der
Atem	der
Aufenthalt	der
Aufprall	der
Aufruhr	der
Aufsatz	der
Aufwand	der
Aufzug	der
Ausbruch	der
Ausdruck	der
Ausschuss	der
Austausch	der
Bach	der
Balkon	der
Ball	der
Ballon	der
Bär	der
Bart	der
Bauch	der
Baum	der
Baumstamm	der
Becher	der
Befehl	der
Begriff	der
Berg	der
Bericht	der
Beruf	der
Besen	der
Besitz	der
Bestand	der
Besuch	der
Beton	der
Beweis	der
Bezirk	der
Bildschirm	der
Biss	der
Bleistift	der
Blick	der
Blitz	der
Block	der
Boden	der
Bogen	der
Bolzen	der
Boom	der
Bordstein	der
Brief	der
Briefkasten	der
Bruchteil	der
Brunnen	der
Büffel	der
Bürgersteig	der
Bus	der
Busch	der
Busen	der
Campus	der
Champagner	der
Charakter	der
Chor	der
Clan	der
Club	der
Cocktail	der
Computer	der
Damm	der
Dampf	der
Dank	der
Darm	der
Daumen	der
Deckel	der
Delphin	der
Dialog	der
Diamant	der
Dollar	der
Donner	der
Drache	der
Drang	der
Druck	der
Dschungel	der
Duft	der
Durchschnitt	der
Efeu	der
Ehrgeiz	der
Eimer	der
Einblick	der
Eindruck	der
Einfluss	der
Eingang	der
Einkauf	der
Einsatz	der
Eintrag	der
Einwand	der
Ekel	der
Elefant	der
Ellbogen	der
Elternteil	der
Empfang	der
Erfolg	der
Esel	der
Faden	der
Faktor	der
Fall	der
Farbton	der
Fehler	der
Feind	der
Fels	der
Felsen	der
Film	der
Finger	der
Fisch	der
Fleck	der
Fluch	der
Flug	der
Flügel	der
Flur	der
Fluss	der
Fokus	der
Fortschritt	der
Frieden	der
Friedhof	der
Frosch	der
Frost	der
Frühling	der
Fuchs	der
Funke	der
Fuß	der
Gang	der
Garten	der
Gedanke	der
Gefallen	der
Gegenstand	der
Geist	der
Geruch	der
Geschmack	der
Gestank	der
Gewinn	der
Gipfel	der
Gips	der
Glaube	der
Globus	der
Golf	der
Gott	der
Graben	der
Granit	der
Griff	der
Grill	der
Grund	der
Gruß	der
Gürtel	der
Guss	der
Haarschnitt	der
Hafen	der
Hai	der
Haken	der
Hals	der
Halt	der
Hammer	der
Handel	der
Handschuh	der
Hang	der
Hass	der
Haufen	der
Haushalt	der
Helm	der
Herbst	der
Herd	der
Himmel	der
Hintern	der
Hinweis	der
Hocker	der
Hof	der
Honig	der
Horizont	der
Horror	der
Hügel	der
Humor	der
Hund	der
Hunger	der
Hurrikan	der
Husten	der
Hut	der
Impuls	der
Index	der
Inhalt	der
Instinkt	der
Jazz	der
Jeep	der
Job	der
Jubel	der
Käfer	der
Kaffee	der
Käfig	der
Kalender	der
Kamin	der
Kamm	der
Kampf	der
Kanal	der
Karton	der
Käse	der
Kauf	der
Kegel	der
Keks	der
Keller	der
Kern	der
Kiefer	der
Kies	der
Klang	der
Knall	der
Knöchel	der
Knochen	der
Knopf	der
Knoten	der
Koffer	der
Komfort	der
Kommentar	der
Konflikt	der
Kongress	der
Kontakt	der
Kontext	der
Kontinent	der
Kontrast	der
Kopf	der
Korb	der
Körper	der
Korridor	der
Kragen	der
Kran	der
Krater	der
Krebs	der
Kredit	der
Kreis	der
Krieg	der
Kristall	der
Krug	der
Kuchen	der
Kurs	der
Kuss	der
Lachs	der
Laptop	der
Laser	der
Lauf	der
Link	der
Lippenstift	der
Löffel	der
Lohn	der
Löwe	der
Luxus	der
Magen	der
Mais	der
Mangel	der
Mantel	der
Markt	der
Marmor	der
Marsch	der
Maulwurf	der
Mechanismus	der
Mist	der
Moment	der
Monat	der
Mond	der
Mord	der
Morgen	der
Motor	der
Müll	der
Mund	der
Muskel	der
Mut	der
Mythos	der
Nagel	der
Name	der
Nebel	der
Nerv	der
Norden	der
Notfall	der
Nutzen	der
Ofen	der
Ohrring	der
Ort	der
Osten	der
Ozean	der
Palast	der
Pantoffel	der
Panzer	der
Park	der
Pass	der
Pelz	der
Penis	der
Pfad	der
Pfeffer	der
Pfeil	der
Pilz	der
Plan	der
Planet	der
Platz	der
Pool	der
Preis	der
Protest	der
Prozess	der
Pullover	der
Punkt	der
Rabe	der
Radar	der
Rahmen	der
Rand	der
Rang	der
Rasen	der
Rat	der
Rauch	der
Raum	der
Rausch	der
Regen	der
Reichtum	der
Reis	der
Reisepass	der
Reiz	der
Rekord	der
Respekt	der
Rhythmus	der
Ring	der
Riss	der
Roman	der
Rücken	der
Rucksack	der
Ruf	der
Ruhm	der
Rumpf	der
Saal	der
Sack	der
Saft	der
Salat	der
Salon	der
Samen	der
Sand	der
Sarg	der
Satellit	der
Sattel	der
Satz	der
Sauerstoff	der
Schädel	der
Schaden	der
Schal	der
Schatten	der
Schatz	der
Schaum	der
Schinken	der
Schlaf	der
Schlag	der
Schlamm	der
Schleier	der
Schluck	der
Schluss	der
Schlüssel	der
Schmerz	der
Schmetterling	der
Schmuck	der
Schmutz	der
Schnaps	der
Schnee	der
Schnitt	der
Schock	der
Schoß	der
Schrank	der
Schrei	der
Schritt	der
Schrott	der
Schub	der
Schuh	der
Schuppen	der
Schuss	der
Schutt	der
Schutz	der
Schwan	der
Schwanz	der
Schwarm	der
Schweiß	der
Schwindel	der
Schwung	der
Segen	der
Sensor	der
Service	der
Sessel	der
Sex	der
Shuttle	der
Sieg	der
Sinn	der
Snack	der
Sommer	der
Spaß	der
Speck	der
Speer	der
Spiegel	der
Sport	der
Sprung	der
Stachel	der
Stahl	der
Stall	der
Stamm	der
Stand	der
Standard	der
Standort	der
Stapel	der
Start	der
Status	der
Staub	der
Stein	der
Stern	der
Stiefel	der
Stiel	der
Stier	der
Stift	der
Stil	der
Stock	der
Stoff	der
Stolz	der
Stoß	der
Strahl	der
Strand	der
Strauß	der
Streifen	der
Streik	der
Stress	der
Strich	der
Strohhalm	der
Strom	der
Strumpf	der
Stuhl	der
Sturm	der
Süden	der
Sumpf	der
Supermarkt	der
Tabak	der
Tag	der
Tanz	der
Tarif	der
Tee	der
Teich	der
Teig	der
Teller	der
Tempel	der
Teppich	der
Termin	der
Terror	der
Test	der
Teufel	der
Text	der
Tipp	der
Tisch	der
Titel	der
Toast	der
Tod	der
Ton	der
Topf	der
Transport	der
Traum	der
Treibstoff	der
Trick	der
Triumph	der
Tropfen	der
Tunnel	der
Turm	der
Umfang	der
Umhang	der
Umschlag	der
Unfall	der
Unsinn	der
Unterricht	der
Unterschied	der
Urlaub	der
Ursprung	der
Ventilator	der
Verbrauch	der
Verdacht	der
Vergleich	der
Verkauf	der
Verkehr	der
Verlust	der
Verrat	der
Verschluss	der
Verstand	der
Versuch	der
Vertrag	der
Vogel	der
Vorfall	der
Vorhang	der
Vorort	der
Vorschlag	der
Vorteil	der
Vortrag	der
Vulkan	der
Wagen	der
Waggon	der
Wal	der
Wald	der
Weg	der
Wein	der
Weizen	der
Wert	der
Wettbewerb	der
Whisky	der
Widerstand	der
Wille	der
Wind	der
Winkel	der
Winter	der
Witz	der
Wodka	der
Wolf	der
Wunsch	der
Wurf	der
Würfel	der
Wurm	der
Zahn	der
Zauber	der
Zaun	der
Zeitplan	der
Zement	der
Ziegel	der
Zirkus	der
Zoo	der
Zopf	der
Zucker	der
Zufall	der
Zug	der
Zugriff	der
Zusammenhang	der
Zustand	der
Zweck	der
Zweifel	der
Zwerg	der
Zwilling	der
Zyklus	der
Zylinder	der

Abteil	das
Bauteil	das
Gegenteil	das
Ersatzteil	das
Einzelteil	das
Netzteil	das
Oberteil	das
Urteil	das
Vorurteil	das

Anteil	der
Bestandteil	der
Bruchteil	der
Erdteil	der
Elternteil	der
Großteil	der
Körperteil	der
Nachteil	der
Vorteil	der
Hauptteil	der
Landesteil	der
Stadtteil	der